20
219 219 82 69 75 84 79 82 219 219 219 219 219 219 219 219 219 219 219 219
219 219 219 219 219 219 219 219 219 219 219 219 219 219 83 65 76 65 219 219
219 219 178 219 219 219 178 219 219 176 176 219 219 219 219 219 219 219 219 219
219 219 178 178 219 178 178 219 219 176 176 219 219 219 219 174 174 219 219 219
219 219 219 178 178 178 219 219 219 176 176 219 219 219 174 174 174 174 219 219
219 219 219 178 178 178 219 219 219 176 176 219 219 219 186 186 186 186 219 219
219 219 219 178 178 178 219 219 219 176 176 219 219 219 186 186 186 186 219 219
219 219 219 178 178 178 219 219 219 176 176 219 219 219 186 186 186 186 219 219
219 219 219 219 219 176 176 176 176 176 176 176 176 176 176 219 219 219 219 219
219 219 219 219 219 176 176 176 176 176 176 176 176 176 176 219 219 219 219 219
219 219 219 219 219 219 219 219 219 176 176 219 219 219 219 219 219 219 219 219
219 219 219 68 79 77 219 219 219 176 176 219 219 219 219 219 219 219 219 219
219 219 219 219 175 219 219 219 219 176 176 219 219 219 219 219 219 219 219 219
219 219 219 175 175 175 219 219 219 176 176 219 219 219 219 219 219 219 219 219
219 219 219 186 186 186 219 219 219 176 176 219 219 219 219 219 219 219 219 219
219 219 219 186 186 186 219 219 219 176 176 219 219 219 219 219 219 219 219 69
219 219 219 219 219 176 176 176 176 176 176 176 176 176 176 176 176 176 219 88
219 219 219 219 219 176 176 176 176 176 176 176 176 176 176 176 176 176 219 73
219 219 219 219 219 219 219 219 219 219 219 219 219 219 219 219 219 219 219 84
219 219 219 219 219 219 219 219 219 219 219 219 219 219 219 219 219 219 219 219